0,0
4,4
...#############
...............#
####..####..####
#..#.....#..#..#
#..####..#..#..#
#........#.....#
####..#######..#
#..#........#..#
#..#..#######..#
#........#.....
#############..
#..#.....#..#..#
#..####..#..#..#
#........#.....#
####..#######..#
#..#........#..#
#..#.....#..#..#
#..####..#..#..#
#........#.....#
